1,1,1,1,1,1,1,1,1,1,1,1,1,1,1,1,1,1,1,1,1,1,1,1
1,0,0,0,0,0,1,1,1,0,0,0,0,0,0,2,1,1,8,0,0,2,0,1
1,0,0,0,0,0,7,0,1,2,1,0,0,0,0,0,1,1,0,0,0,0,0,1
1,1,0,0,0,0,0,0,1,0,0,0,0,0,0,0,0,0,0,0,2,0,0,1
1,1,0,0,1,1,0,0,1,1,1,1,0,0,0,7,8,0,0,0,1,0,0,1
1,0,0,0,0,1,0,8,0,0,0,0,0,0,0,1,1,1,1,1,1,0,0,3
1,0,0,0,0,1,0,1,1,1,1,0,0,0,0,8,0,0,0,0,1,1,0,1
1,0,0,1,0,0,0,0,0,2,0,0,8,0,0,0,0,0,2,0,0,0,0,1
1,0,0,1,0,0,0,0,0,1,1,0,0,0,0,0,1,1,1,0,0,0,0,1
1,0,0,0,0,0,0,0,0,0,8,0,0,0,8,0,0,0,0,0,0,1,1,1
1,8,0,2,0,0,0,1,1,0,0,0,0,2,0,0,0,0,0,0,2,1,1,1
1,1,1,1,1,1,1,1,1,1,1,1,1,1,1,1,1,1,1,1,1,1,1,1

